0000000000001100000001110000021000002202222100000000000000000000001110000000001222111111100000000000
0000000000011110011111110000021100002222222210000000000000022222222111000000222222112221110000000000
0000000000011111111111110000121100000222222221000000222222222222222111110022222222122221112000000000
0000000000111111100011110000122200000122222221000002222222222222222221121200222222222221122211100002
0000000000111111000001110001222200000022222221000222202120202020212221122212221221222222222211110002
0011120001111110000001110011211100000000021122000202000000000000022222222222222220011122211211110002
2222222221122100000021100011211000000000001122222222000000000000112122221222122100001112100211110002
0222222222222200001121000002210000000000000002222202020000000002222212221111102220000112000221100002
2222221122222220011222222002100002220000000000022222220000000002111111221111002221000000000221000002
2222121112111221222220002222100002200001100000022222220000000002111111211111112111000000000122220002
2222211112001222222200000222100222222222222000012222222200000022111111211111222111000000000000222002
2222222110000222222000000211112222222222222001122202222220000012111111222222211110000000000000002202
1211122210000020002000000212222200222222222111222200022222222112111111112111111100000011000000002202
2211112221000000000000000222220000222200122112221200000012222112111111111111000000000011000000002112
0110012222220000000010000222220000020200222222222200000001221112111111101111000000000111000000002222
0000001122222222221111000222120000022200222222211100000001222222111110000111000000001111000000000002
0000001112111200221111000122121000002222222222211000000001222222211100000111000000001111000000110000
0000001111111100022211000121221000000221211111100000000001222122221100000110000000001111000011111000
0000011111111000012222001122210000000221211111000000000000122222221110000110000000001110000111111000
0001111111000000001112212221210000000222221110000000000000002222121111001210000000001110000111111100
0011111110000000000002222112212001110012221110000000000000001111122211111210000000000110000111111100
0011110000000000000002112222222222222222221110000000000000001111112222111210000000000110000011111100
0011100000001100000022222111221121122220001111000001111111111111100012222210000000201111000000001100
0111100000011110000021112111111111112220000111110011111111111111000000111200000000211111111100000000
0111000000011110000021111111111111111110201111111111111111111111000000011000000000211111111110000000
0110000000011110000221111111111110011111211111111111111111001111000000000000000000211111111110000000
0000001100111110000021111111111100001111211111111110011110000111000000000000000000211111111100000000
0000001111111110001020111111111000000011211111111100001110000011000000000000000000011111111000000000
0000001111111100000020011111110000000001211100000000000000000000000000000000000000011111110000000000
0000000000000000000000000000000000000000110000000000000000000000000000000000000000001111000000000000
