00110000011110000000000200200000000000110000000000001110001111100000000000000022
22111000111111000000000200201110000001111000000000011111111111100000000000000022
02221000111111100000000222211110000201111000010000011111111111100000011000011120
22221000111111110000000022211110000201111000112000111111111111100000111100111120
22222000111111111000000022221100000201111000112111111111111111100000111111111120
22212111121221222111000022222000000200111000012111111111111111100000111111111110
01222222222222222111000022222000002200111000002111111111111000000000011110011100
00222222222222222121000222222200111201111000002111110111110000000000001100001100
00001122222220022221101200222222222221111000012111100000000000000000011000000000
00001110011100002221111200012222222222110000112111100000000000000000111000000000
20011100000000000222211200001111111212100002222111100000000000000001110000000000
22111100000000000022222200000000111112110022112111100001110000000011100000000000
22221110000000000001222100000000000112211221111111110011111000001111000000000000
22222222222222220000022100000000000012222222211111111111111100111110000000001110
22222222221121222000022200000020002222221122111111111111111111111110000000001110
12221112121022222210022222100222222222122222100001111111110111111100000000000000
12221111110000112222222222202222222200011122200001111111100012221100000000000000
12111111110000011222222222222220022200000022221001111100000112121200000000000000
12111111100000000000221222222220002000000000222221111000000122222210000000000000
12111111100000000000121111121000002000000000012222222000000111122211000000000000
12111111000111000000011111111100002011100000002001122100000011222222200000000000
12211110000111100000011111111100002011100000000002222110000011111212220000000000
22222200000111100000001111111110002011100000000002122111000011111111122200000000
12000000000111100000000011111110002011100000011112222111000001111111112220000000
10000000000111000000000001111110002011100000222222112110000000111111111222000111
00000000001110000000000000111100002111100002211112112110000000001111111112222111
00000000011110000011000000111000002111000002111111112110000000000011100111212110
00000000111111000111000001111100002111000012111111112210000000000000000111222110
00110000111111111110002001111100002111000012101111111210000011000000001111221110
01111000011111111100002011111100012111000112101111111200001111100000001111122210
22221000011111111100002111111100012211000222111111110200011111110000011110002222
01122220011111111100002111111000012211002211111111100220111111111100111100000002
00110000011110011100002111111000002211122111121111100022221111111111111110000000
00000000111100001100012111111100002212221111121111000001121111011111111111000000
00000001111100011000112111111110012222111111121110000001110000001111111111000000
00000011111111110000112111111111122222111111121100000011100000000111111110000000
00000011111111100000112111111111121221111111121100000111000000000111111100000000
00000001111111000000011111111111121211111111111100000111000010000011111100000000
00000000110000000000001111110011121211111111111000000010000111000001111000000000
00000000000000000000000000000000000000000000000000000000000011000000000000000000
