0122222110022222110000000000000222202000000000000000000000000000000000000011000000000000000000000000
1121112111002221221202000000000002222200000000000000000000000000000000000011100022100000000000000000
2221112222222222222222000000000002221222222000001111000000011000011000000001111122210000000000000000
1110011110002222022212000000000000222222222100011111100000011200111210000000111222222000000000000000
1100001110002222002222100000000002222222222111111111100000011221122211100000012221112200000000011000
0000001110002221011222100000000022222202222212222111000000112222222211111000022221102222000000111100
0000001111002221111111100000000022222200122222222211000000112222222221111000222121000022000001111110
2000001111001222111111112011100222220220022222112222200001112212222222220002222110000022222221111110
0000000111111221111111112111100222200022222221111222211022222222211001110022222100000001222222111110
0011000111111222222111112222000222000002022222221122222222211101111111100222222000000001111112121100
0111100011111222212222222102200022000222000001111111122222111000111111100222221000111111111112221000
0111100011110222222211122000220022000200000000011111110222222222222222222222210001111110011112221000
0111110001100222012211111100020022000200000000001111100001221111111111100000000001111100001122222000
0111111011100222222222221100022222200210222220000111110000121111111111000000000001111000000111222222
1111111111100022212111122110000222222222222222200111111000121111111110000000110001110000000012210000
1111111111110022212100122220002222112222000222211111111001121111111100000000111000000000002222111000
1111111111110002202000022120022221111111000022222111110001122000111100000000111000000000002111111100
1111111111110000222200022220222222200010000012222210000001112222111110000000111100000000022111121100
0111111111100000000200001222222221000000000001222200000000110000011110000000111100000000022112221100
0011111100000000002200000002222211000000000000122200000000000000011110000000111110000000022222222100
0000000000000011102000000022222211100000011000022200121100000000001110000000111110000000222222222100
0000000000000112212000000022221111111111111100002222221111000000000000000001111111000000022222222222
0000000000002222222000000222222111111111111110000022221111100000002200000011111111000000022212000002
0000000000000222222222222222221111111111111110000001222212222222212000000011111111000000001210000000
0111000002202221120022222222221110001110011110000000122222222222222000000012222222222222222220000000
0111100022222222222222222222221100000000000000000000000000022112222220000012111100000000000000000000
0011000222221111100222220011111000000000000000000000000000001112110000000012111000000000000000000000
0000000222221110000000000000000000000000000000000000000000001111100000000112110000000000000000000000
0000000011211000000000000000000000000000000000011000000000000111100000000111100000000000000000000000
0000000000000000000000000000000000000000000000000000000000000011000000000000000000000000000000000000
