22222222222000022220000000000000000000000000112222
22222222220000002220000000000000000000000000122102
22222222200011000022221110000000000000000000221100
00000011001111100022211110000000000000000000211000
00000011001111100002222210000011000000100002210000
00000000001111100022222110000111110001110002210000
00000000000111000022222110000111111111110002200000
00000000000020000112122200001111111111110022100000
22000002222222222222210220011111110111100022100000
22220012122020000010000222222111100011100022200000
22222112220022200000000222222222000001000122000000
22222222210000222000000002222222000000002222000100
22222222200000220000000000111222200000022222111110
22002222200000222000000000000012220000021221111100
02200022110000012222200000000002220000222222111100
02200001111000000000200000000001222222221111111100
12200001111000000000200000000001122211221111111110
22200001111000000000222200000001112212211111111110
22100001111000000000110200000011112222221111111110
22000011110001211001100222222111111122111111000000
22000011100222222221100002222211100112111110000000
20022000000022222222200001122211000011111111000000
22222200000222122222200001121111100001111111111100
22200220022222211122220011122221112000111111111110
12102222222222211112221111112221112101111111111110
00002222222222211111221111112211122111111100111110
00000002222222111111122211222211122111111000011110
00000000222211111110012211222211112211110000011110
00000000022210000000012222222211112211110000111110
00000000222100000000011222222211111211110011211100
20000012221100000000111110002222111221221122211100
20000022221000000000111100000222111121222222222110
22000002221000000000111000000222100122222222222222
22200000210000011000010000000222000022212111222220
22000000220000111000000000000222000022211111111100
22000000210000011000000000002222200022211111100000
22000002221000000000000000022220222222221111000000
22000022222100002200000000012220202222211111000000
22200021222202222222001000222222222222221111100000
22222221122222222222222100222100002222211111111000
22222222222222222222222222222200000022111111111000
00222221222100000022222200020000000022111111100000
00022222211000000000022200000000000002111111000000
00000122000000000000002200000000010001111110000000
00000000000001000000000000000000111101111000000000
00000000000011110000000000000000111111110000000000
00000000000011111000000000000000011111110000000000
00000000000011111000000000000000011111110000000000
00000000000001111000000000000000001111100000000000
00000000000000000000000000000000000111000000000000
