00222221111000011111000222000000000000011000222222
02222211111200222121100022222220000012212222222222
22222222222222222222210002222220000222222222222222
22222222222222222222222022222222222222222112222220
22222212222022222222222122222222222222221102222020
00000111111002000002222222222022222221111000002000
00000011111100000000122222220022212221111100000000
01100001111110000000022222210002111222111110002000
11110001111111111100022221100000110022111110002000
11110000111111111110022222100000000022211110002000
11111000011111111110022222100000000022222110002000
11111100001111111110022222100000000022222210002000
11111100000111111100002222200000000002221221002100
00001110000111111100001222110000000001222221112110
00000000000011111110000221111000000000122222112110
00000000000000011110000000110000000000111222222100
00000000000000001100000000000002000000000022222100
01100000111000000000000000000002210000000002222100
11110001111100000000000000000002200000000022222100
11110011111000000000000000000022220000000022222100
01111111100000000000000000000002022220000222221100
01111111000000000000000022222222200020002222211100
01111110000000011110000020000000000022001222211100
01111110000000111111000020000000000022221121111100
01111110000000111111000220000000000222022222111000
01111110000000111110000121110000002222011111110000
01111110000000011000000122211000002212000011110000
01111110000000000000000001211100002222000011111000
11111110000000000000000000221100000212000011111100
21111110000000000000000000211000000222211111111110
21111110000000000001100001211000000012221211111110
21111100000000000022210012210000000001221211111110
21100000000000000121212222220000011000122211111100
20000000000000012221222222110000111100122221111100
20000000000000111221122112110000111100022221111100
20000000000001111121112111110000011000011121111100
20000000000012222222111111100000000000011111111000
22011111000012211111111111000000000000011111111000
02111111100222211111111110000000000000011111111000
02111111110022211111111110000000000000011111110000
02211111110002111111111110000000000000011111110000
01211001100002221100011111000000000000001111110000
00210000000000121000011111111100000000001111111000
00222222222222222000011111111111000000011111111100
00221000000000000000011110001111100011111111111100
01121100000000000000111100000111111111111111111000
01121100000000001111111000000111111111100000000000
00111000000000011111111000000011111111000000000000
00000000000000011111110000000000111000000000000000
00000000000000001000000000000000000000000000000000
